1111111111111111.......................................
1CCCCCCCCCCCCCC1.......................................
1CCCCCCCCCCCCCC1.......................................
1CCCCCCCCCCCCCC1.......................................
1CCCCCCCCCCCCCC1.......................................
1CCCCCMMCCCCCCC1.......................................
1CCCCCMMCCCCCCC1.......................................
1CCCCCCCCCCCCCC1.......................................
1CCCtCCCCCCtCCC1.......................................
1CCCtCCCCCCtCCC1.......................................
1CCCtCCCCCCtCCC1.......................................
1CCCtCCCCCCtCCC1.......................................
1CCCtCCCCCCtCCC1.......................................
1CCCtCCCCCCtCCC1.......................................
1CCCtCCCCCCtCCC1.......................................
1CCCCCCCCCCCCCC1.......................................
1CCCCCCCCCCCCCC1.......................................
1CCCCCCCCCCCCCC1.......................................
1CCCCCCCCCCCCCC1.......................................
1111111CCCCCCCC1.......................................
......1CCCCCCCC1.......................................
......1111DDDDD1.......................................
.........1CCCCC1.......................................
.........1CCCCC1.......................................
.........1CCCCC1.......................................
....111111CCCCC1.......................................
....1CCCCDCCCCC1.......................................
....1CCCCDCCCCC1.......................................
....1CCCCDCCCCC1HHHHHHJ................................
....1CCCCDCCCCC1bbbbbbR................................
....111111CCCCC1bbbbbbR................................
....1CCCCDCCCCC1bbbbbbR................................
....1CCCCDCCCCC1bbbbbbR................................
....1CCCCDCCCCC1bbbbbbR................................
....1CCCCDCCCCC1DDDDDD111..............................
....111111CCCCCCCCTTTTR................................
.........1CtCCCtCCTTTTR................................
.........1CCCCCCCCTTTTR................................
.........1CtCCCtCCTTTTR................................
.........1CCCCCCCCTTTTR................................
.........1CCCCCCCCTTTTKHHHHHHHHHHHHHHHHH1..............
.........1TTTTTTTTTTTTTTTTTTTTTTTTTTTTTT1..............
.........1TTTTTTTTTTTTTTTTTTTTTTTTTTTTTT1..............
.........1TTTTTTTTTTTTTTTEEETTTTTTTTTTTT1..............
.........1TTTTTTTTTTTTTTTEEETTTTTTTTTTTT1..............
.........1TTTTTTTTTTTTTTTEEETTTTTTTTTTTT1..............
.........1TTTTTTTTTTTTTTTTTTTTTTTTTTTTTT1..............
1111111111111111111111111TTTTT11111111111..............
....1CCCCCCCCCCCCCCCCCCC1TTTTT1........................
....1CCCCCCCCCCCtCCCCCCCDTTTTT1........................
....1CCCCCCCCCCCCCCCCCCCDTTTTT1........................
....1CCCCCtCCCCCCCCCCCCCDTTTTT1........................
....1CCCCCCCCCCCCCCCCCCCDTTTTT1........................
....1CCCCCCCCCCCCCtCCCCCDTTTTT1........................
....1CCCCCCCCCCCCCCCCCCCDTTTTT1........................
....1CCCCCCCCCCCCCCCCCCC1TTTTT11111111.................
....1CCCCCCCCCCCCCCCCCCC1TTTTTDCCCCCC1.................
....1CtCCCCCCCCCCCCtCCCC1TTTTTDCCCCCC1.................
....1CCCCCCCCCCCCCCCCCCC1TTTTTDCCCCCC1.................
....1CCCCCCCCCCCCCCCCCCC1TTTTTDCCtCCC1.................
....1CCCCCCCCCCCCCCCCCCC1TTTTTDCCCCCC1.................
....1CCCCCCCCCCCCCCCCCCC1TTTTTDCCCCCC1.................
....1CCCCCCCCCCCCCtCCCCC1TTTTT11111111.................
....1CCCCCCCCCCCCCCCCCCC1TTTTTDCCCCCC1.................
....1CCCCCCCCCCCCCCCCCCC1TTTTTDCCCCCC1.................
....1CCCCCCCCCCCCCCCCCCC1TTTTTDCCCCCC1.................
....1CCCCCCCCCCCCCCCCCCC1TTTTTDCCtCCC1.................
....1CCCCCtCCCCCCCCCCCCC1TTTTTDCCCCCC1.................
....1CCCCCCCCCCCCCCCCCCC1TTTTTDCCCCCC1.................
....1CCCCCCCCCCCCCCCCCCCDTTTTT11111111.................
....1CCCCCCCCCCCCtCCCCCCDTTTTTDCCCCCC1.................
....1CCCCCCCCCCCCCCCCCCCDTTTTTDCCCCCC1.................
....1CCCCCCCCCCCCCCCCCCCDTTTTTDCCCCCC1.................
....1CtCCCCCCCCCCCCCCCCCDTTTTTDCCtCCC1.................
....1CCCCCCCCCCCCtCCCCCCDTTTTTDCCCCCC1.................
....1CCCCCCCCCCCCCCCCCCC1TTTTTDCCCCCC1.................
....111111111111111111111TTTTT1111111111111111111111111
....1CCCCCCCCCCCCCCCCCCCDTTTTTDCCCCCCCCCCCCCCCCCCCCCCC1
....1CCCCCtCCCCCCCCCCCCCDTTTTTDCCCCCCCCCCCCCCCCCCCCCCC1
....1CCCCCCCCCCCCCCCCCCCDTTTTTDCCCCCCCCCCCCCCCCCCCCCCC1
....1CCCCCCCCCCCCCCCCCCCDTTTTTDCCCCCCCCCCCCCCCCCCCCCCC1
....1CCCCCCCCCCCCCCCCCCCDTTTTTDCCCCCCCCCCCCCCCCCtCCCCC1
....1CCCCCCCCCCCCCCCCCCCDTTTTTDCCCCtCCCCCCCCCCCCCCCCCC1
....1CCCCCCCCCCtCCCCCCCC1TTTTT1CCCCCCCCCCCCCCCCCCCCCCC1
....1CCCCCCCCCCCCCCCCCCC1TTTTT1CCCCCCCCCCCCCCCCCCCCCCC1
....1CCCCtCCCCCCCCCCCCCC1TTTTT1CCCCCCCCCCCCCCCCCCCCCCC1
....1CCCCCCCCCCCCCCCCCCC1TTTTT1CCCCCCCCCCCCCCCCCCCCCCC1
....1CCCCCCCCCCCCCCCCCCC1TTTTT1CCCtCCCCCCCCCCCCCCCCCCC1
....1CCCCCCCCCCCCCCCCCCC1TTTTT1CCCCCCCCCCCCCCCCCCCCCCC1
....1CCCCCCCtCCCCCCCCCCC1TTTTT1CCCCCCCCCCCCCCCCCCCCCCC1
....1CCCCCCCCCCCCCCCCCCC1TTTTT1CCCCCCCCCCCCCtCCCCCCCCC1
....1CCCCCCCCCCCCCCCCCCC1TTTTT1CCCCCCCCCCCCCCCCCCCCCCC1
....1CCCCCCCCCCCCCCCCCCC1TTTTT1CCCCCCCCCCCCCCCCCCCCCCC1
....1CCCCCCCCCCCCCCCCCCC1TTTTT1CCCCCCCCCCCCCCCCCCCCCCC1
....1CCCCCCCCCCCCCCCCCCC1TTTTT1CCCCCCtCCCCCCCCCCCCCCCC1
....1CCCCCCCCCCCCCtCCCCC1TTTTT1CCCCCCCCCCCCCCCCCCCCCCC1
....1CCCCCCCCCCCCCCCCCCCDTTTTTDCCCCCCCCCCCCCCCCCCCCCCC1
....1CCCCCCCCCCCCCCCCCCCDTTTTTDCCCCCCCCCCCCCCCCCCCCCCC1
....1CCCCCCCCCCCCCCCCCCCDTTTTTDCCCCCCCCCCCCCCCCCCCCCCC1
....1CCCCtCCCCCCCCCCCCCCDTTTTTDCCCCCCCCCCCCCCCCCCCCCCC1
....1CCCCCCCCCCCCCCCCCCCDTTTTTDCCCCCCCCCCCCCCCCCCCCCCC1
....1CCCCCCCCCCCCCCCCCCCDTTTTTDCCCCCCCCCCCCCCCCCCCCCCC1
....111111111111111111111111111111111111111111111111111