1111111111111111.......................................
1CCCCCCCCCCCCCC1.......................................
1CCCCCCCCCCCCCC1.......................................
1CCCCCCCCCCCCCC1.......................................
1CCCCCCCCCCCCCC1.......................................
1CCCCCCCCCCCCCC1.......................................
1CCCCCCCCCCCCCC1.......................................
1CCCCCCCCCCCCCC1.......................................
1CCCCCCCCCCCCCC1.......................................
1CCCCCCCCCCCCCC1.......................................
1CCCCCCCCCCCCCC1.......................................
1CCCCCCCCCCCCCC1.......................................
1CCCCCCCCCCCCCC1.......................................
1CCCCCCCCCCCCCC1.......................................
1CCCCCCCCCCCCCC1.......................................
1CCCCCCCCCCCCCC1.......................................
1CCCCCCCCCCCCCC1.......................................
1CCCCCCCCCCCCCC1.......................................
1CCCCCCCCCCCCCC1.......................................
1111111CCCCCCCC1.......................................
......1CCCCCCCC1.......................................
......1111DDDDD1.......................................
.........1CCCCC1.......................................
.........1CCCCC1.......................................
.........1CCCCC1.......................................
....111111CCCCC1.......................................
....1CCCCDCCCCC1.......................................
....1CCCCDCCCCC1.......................................
....1CCCCDCCCCC1HHHHHHJ................................
....1CCCCDCCCCC1......R................................
....111111CCCCC1......R................................
....1CCCCDCCCCC1......R................................
....1CCCCDCCCCC1......R................................
....1CCCCDCCCCC1......R................................
....1CCCCDCCCCC1DDDDDD111..............................
....111111CCCCCCCCTTTTR................................
.........1CCCCCCCCTTTTR................................
.........1CCCCCCCCTTTTR................................
.........1CCCCCCCCTTTTR................................
.........1CCCCCCCCTTTTR................................
.........1CCCCCCCCTTTTKHHHHHHHHHHHHHHHHH1..............
.........1TTTTTTTTTTTTTTTTTTTTTTTTTTTTTT1..............
.........1TTTTTTTTTTTTTTTTTTTTTTTTTTTTTT1..............
.........1TTTTTTTTTTTTTTTEEETTTTTTTTTTTT1..............
.........1TTTTTTTTTTTTTTTEEETTTTTTTTTTTT1..............
.........1TTTTTTTTTTTTTTTEEETTTTTTTTTTTT1..............
.........1TTTTTTTTTTTTTTTTTTTTTTTTTTTTTT1..............
1111111111111111111111111TTTTT11111111111..............
....1CCCCCCCCCCCCCCCCCCC1TTTTT1........................
....1CCCCCCCCCCCCCCCCCCCDTTTTT1........................
....1CCCCCCCCCCCCCCCCCCCDTTTTT1........................
....1CCCCCCCCCCCCCCCCCCCDTTTTT1........................
....1CCCCCCCCCCCCCCCCCCCDTTTTT1........................
....1CCCCCCCCCCCCCCCCCCCDTTTTT1........................
....1CCCCCCCCCCCCCCCCCCCDTTTTT1........................
....1CCCCCCCCCCCCCCCCCCC1TTTTT11111111.................
....1CCCCCCCCCCCCCCCCCCC1TTTTTDCCCCCC1.................
....1CCCCCCCCCCCCCCCCCCC1TTTTTDCCCCCC1.................
....1CCCCCCCCCCCCCCCCCCC1TTTTTDCCCCCC1.................
....1CCCCCCCCCCCCCCCCCCC1TTTTTDCCCCCC1.................
....1CCCCCCCCCCCCCCCCCCC1TTTTTDCCCCCC1.................
....1CCCCCCCCCCCCCCCCCCC1TTTTTDCCCCCC1.................
....1CCCCCCCCCCCCCCCCCCC1TTTTT11111111.................
....1CCCCCCCCCCCCCCCCCCC1TTTTTDCCCCCC1.................
....1CCCCCCCCCCCCCCCCCCC1TTTTTDCCCCCC1.................
....1CCCCCCCCCCCCCCCCCCC1TTTTTDCCCCCC1.................
....1CCCCCCCCCCCCCCCCCCC1TTTTTDCCCCCC1.................
....1CCCCCCCCCCCCCCCCCCC1TTTTTDCCCCCC1.................
....1CCCCCCCCCCCCCCCCCCC1TTTTTDCCCCCC1.................
....1CCCCCCCCCCCCCCCCCCCDTTTTT11111111.................
....1CCCCCCCCCCCCCCCCCCCDTTTTTDCCCCCC1.................
....1CCCCCCCCCCCCCCCCCCCDTTTTTDCCCCCC1.................
....1CCCCCCCCCCCCCCCCCCCDTTTTTDCCCCCC1.................
....1CCCCCCCCCCCCCCCCCCCDTTTTTDCCCCCC1.................
....1CCCCCCCCCCCCCCCCCCCDTTTTTDCCCCCC1.................
....1CCCCCCCCCCCCCCCCCCC1TTTTTDCCCCCC1.................
....111111111111111111111TTTTT1111111111111111111111111
....1CCCCCCCCCCCCCCCCCCCDTTTTTDCCCCCCCCCCCCCCCCCCCCCCC1
....1CCCCCCCCCCCCCCCCCCCDTTTTTDCCCCCCCCCCCCCCCCCCCCCCC1
....1CCCCCCCCCCCCCCCCCCCDTTTTTDCCCCCCCCCCCCCCCCCCCCCCC1
....1CCCCCCCCCCCCCCCCCCCDTTTTTDCCCCCCCCCCCCCCCCCCCCCCC1
....1CCCCCCCCCCCCCCCCCCCDTTTTTDCCCCCCCCCCCCCCCCCCCCCCC1
....1CCCCCCCCCCCCCCCCCCCDTTTTTDCCCCCCCCCCCCCCCCCCCCCCC1
....1CCCCCCCCCCCCCCCCCCC1TTTTT1CCCCCCCCCCCCCCCCCCCCCCC1
....1CCCCCCCCCCCCCCCCCCC1TTTTT1CCCCCCCCCCCCCCCCCCCCCCC1
....1CCCCCCCCCCCCCCCCCCC1TTTTT1CCCCCCCCCCCCCCCCCCCCCCC1
....1CCCCCCCCCCCCCCCCCCC1TTTTT1CCCCCCCCCCCCCCCCCCCCCCC1
....1CCCCCCCCCCCCCCCCCCC1TTTTT1CCCCCCCCCCCCCCCCCCCCCCC1
....1CCCCCCCCCCCCCCCCCCC1TTTTT1CCCCCCCCCCCCCCCCCCCCCCC1
....1CCCCCCCCCCCCCCCCCCC1TTTTT1CCCCCCCCCCCCCCCCCCCCCCC1
....1CCCCCCCCCCCCCCCCCCC1TTTTT1CCCCCCCCCCCCCCCCCCCCCCC1
....1CCCCCCCCCCCCCCCCCCC1TTTTT1CCCCCCCCCCCCCCCCCCCCCCC1
....1CCCCCCCCCCCCCCCCCCC1TTTTT1CCCCCCCCCCCCCCCCCCCCCCC1
....1CCCCCCCCCCCCCCCCCCC1TTTTT1CCCCCCCCCCCCCCCCCCCCCCC1
....1CCCCCCCCCCCCCCCCCCC1TTTTT1CCCCCCCCCCCCCCCCCCCCCCC1
....1CCCCCCCCCCCCCCCCCCC1TTTTT1CCCCCCCCCCCCCCCCCCCCCCC1
....1CCCCCCCCCCCCCCCCCCCDTTTTTDCCCCCCCCCCCCCCCCCCCCCCC1
....1CCCCCCCCCCCCCCCCCCCDTTTTTDCCCCCCCCCCCCCCCCCCCCCCC1
....1CCCCCCCCCCCCCCCCCCCDTTTTTDCCCCCCCCCCCCCCCCCCCCCCC1
....1CCCCCCCCCCCCCCCCCCCDTTTTTDCCCCCCCCCCCCCCCCCCCCCCC1
....1CCCCCCCCCCCCCCCCCCCDTTTTTDCCCCCCCCCCCCCCCCCCCCCCC1
....1CCCCCCCCCCCCCCCCCCCDTTTTTDCCCCCCCCCCCCCCCCCCCCCCC1
....111111111111111111111111111111111111111111111111111