1111111111111...111111111111.................................................
1TTTTTDCCCCC1...1AATTTTTTTT1.................................................
1TTTTTDCCCCC1...1AATTTTTTTT1......1111111....................................
1TTTTTDCCCCC1...1AATTTTTTTT1......1CCCCCC111111..............................
1TTTTTDSSSSS1...1AATTTTTTTT1......1CCCCCCCCCCCC111111........................
1TTTTT1111111111111TTTTTTTT1......1CCCCCCCCCCCCCCCCCC11111...................
1TTTTTTTTTTTTTTTTTTTTTTTTTT1......1CCCCCCCCCCCCCCCCCCCCCCC1111...............
1TTTTTTTTTTTTTTTTTTTTTTTTTT1......1CCCCCCCCCCCCCCCCCCCCCCCCCCC111............
1TTTTTTTTTTTTTTTTTTTTTTTTTT1......1CCCCCCCCCCCCCCCCCCCCCCCCCCCCCC11..........
1TTTT111111111111TTTTT111111......1CCCCCCCCCCCCCCCCCCCCCCCCCCCCCCCC11........
1TTTT1..........1TTTTTDCCCC1......1CCCCCCCCCCCCCCCCCCCCCCCCCCCCCCCCCC1.......
1TTTT1..........1TTTTTDCCCC1......1CCCCCCCCCCCCCCCCCCCCCCCCCCCCCCCCCCC1......
1TTTT1..........1TTTTTDCCCC1......1CCCCCCCCCCCCCCCCCCCCCCCCCCCCCCCCCCC1......
1TTTT1..........1TTTTTDCCCC1......1CCCCCCCCCCCCCCCCCCCCCCCCCCCCCCCCCCCC1.....
1TTTT1..........1TTTTT111111......1CCCCCCCCCCCCCCCCCCCCCCCCCCCCCCCCCCCC1.....
1TTTT1..........1TTTTTDCCCC1......1CCCCCCCCCCCCCCCCCCCCCCCCCCCCCCCCCCCCC1....
1TTTT1..........1TTTTTDCCCC1......1CCCCCCCCCCCCCCCCCCCCCCCCCCCCCCCCCCCCC1....
1TTTT1..........1TTTTTDCCCC1......1CCCCCCCCCCCCCCCCCCCCCCCCCCCCCCCCCCCCC1....
1TTTT1..........1TTTTTDCCCC1......1CCCCCCCCCCCCCCCCCCCCCCCCCCCCCCCCCCCCCC1...
1TTTT1.......1111TTTTT111111......1CCCCCCCCCCCCCCCCCCCCCCCCCCCCCCCCCCCCCC1...
1TTTT1.......1VVVTTTTTTTTTT1......1CCCCCCCCCCCCCCCCCCCCCCCCCCCCCCCCCCCCCC1...
1TTTT1.......1VVVTTTTTTTTTT1......1CCCCCCCCCCCCCCCCCCCCCCCCCCCCCCCCCCCCCC1...
1TTTT1.......1TTTTTTTTTTTTT1DDDDDD1CCCCCCCCCCCCCCCCCCCCCCCCCCCCCCCCCCCCCCC1..
1TTTT1.......1TTTTTTTTTTTTT1TTTTTTTCCCCCCCCCCCCCCCCCCCCCCCCCCCCCCCCCCCCCCC1..
1TTTT1.......1VVVTTTTTTTTTT1TTTTTTTCCCCCCCCCCCCCCCCCCCCCCCCCCCCCCCCCCCCCCC1..
1TTTT1.......1VVVTTTTTTTTTT1TTTTTTTCCCCCCCCCCCCCCCCCCCCCCCCCCCCCCCCCCCCCCC1..
1TTTT1...11111111TTTTTTTTTT1TTTTTTTCCCCCCCCCCCCCCCCCCCCCCCCCCCCCCCCCCCCCCC1..
1TTTT1...1SSSSSS1TTTTTTTTTT1TTTTTTTCCCCCCCCCCCCCCCCCCCCCCCCCCCCCCCCCCCCCCCC1.
1TTTT1...1SSSSSS1TTTTTTTTTT1TTTTTTTCCCCCCCCCCCCCCCCCCCCCCCCCCCCCCCCCCCCCCCC1.
1TTTT1...1SSSSSS1TTTTTTTTTTTTTTTTTTCCCCCCCCCCCCCCCCCCCCCCCCCCCCCCCCCCCCCCCC1.
1TTTT1...1SSSSSS1TTTTTTTTTTTTTTTTTTCCCCCCCCCCCCCCCCCCCCCCCCCCCCCCCCCCCCCCCC1.
1TTTT1...11111111TTTTTTTTTTTTTTTTTTCCCCCCCCCCCCCCCCCCCCCCCCCCCCCCCCCCCCCCCC1.
1TTTT1...1SSSSSSSTTTTTTTTTTTTTTTTTTCCCCCCCCCCCCCCCCCCCCCCCCCCCCCCCCCCCCCCCC11
1TTTT1...1TTTTTTTTTTTTTTTTTTTTTTTTTTTTTTTTTTTTTTTTTTTTTTTTTTTTTTTTT1111111111
1TTTT1...1TTTTTTTTTTTTTTTTTTTTTTTTTTTTTTTTTTTTTTTTTTTTTTTTTTTTTTTTTCCCC1....R
1TTTT1...1TTTTTTTTTTTTTTTTTTTTTTTTTTTTTTTTTTTTTTTTTTTTTTTTTTTTTTTTTTTTTD....R
1TTTT1...1TTTTTTTTTTTTTTTTTTTTTTTTTTTTTTTTTTTTTTTTTTTTTTTTTTTTTTTTTTTTTD....R
1TTTT1...1TTTTTTTTTTTTTTTTTEEETTTTTTTTTTTTTTTTTTTTTTTTTTTTTTTTTTTTTTTTTD....R
1TTTT1...1TTTTTTTTTTTTTTTTTEEETTTTTTTTTTTTTTTTTTTTTTTTTTTTTTTTTTTTTTTTTD....R
1TTTT1...1TTTTTTTTTTTTTTTTTEEETTTTTTTTTTTTTTTTTTTTTTTTTTTTTTTTTTTTTCCCC1....R
1TTTT1...1TTTTTTTTTTTTTTTTTTTTTTTTTTTTTTTTTTTTTTTTTTTTTTTTTTTTTTTTT1111111111
1TTTT1...1TTTTTTTTTTTTTTTTTTTTTTTTTTTTTTTTTTTTTTTTTTTTTTTTTTTTTTTTTTTTT1.....
1TTTT11111TTTTTTTTTTTTTTTTTTTTTTTTTTTTTTTTTTTTTTTTTTTTTTTTTTTTTTTTTTTTT1.....
1TTTTTTTTTTTTTTTTTTTTTTTTTTTTTTTTTTTTTTTTTTTTTTTTTTTTTTTTTTTTTTTTTTTTTT1.....
1TTTTTTTTTTTTTTTTTTTTTTTTTTTTTTTTTTTTTTTTTTTTTTTTTTTTTTTTTTTTTTTTTTTTTT1.....
1TTTTTTTTTTTTTTTTTTTTTTTTTTTTTTTTTTTTTTTTTTTTTTTTTTTTTTTTTTTTTTTTTTTTTT1.....
1TTTTTTTTTTTTTTTTTTTTTTTTTTTTTTTTTTTTTTTTTTTTTTTTTTTTTTTTTTTTTTTTTTTTTT1.....
111111111111111111111111111111111111111111111111111111111111111111111111.....