11111111111111GGG111111111111GGGGGG...........................................
1TTTTTDCCCCCC1GGG1AATTTTTTTT1GGGGGG...........................................
1TTTTTDCtCCCC1GGG1AATTTTTTTT1GGGGGG...........................................
1TTTTTDCCCCCC1GGG1AATTTTTTTT1GGGGGG...........................................
1TTTTTDCCCCCC1GGG1AATTTTTTTT1GGGGGG...........................................
1TTTTTDCCCCCC1GGG1AATTTTTTTT1GGGGGG...........................................
1TTTTTDSSSSSS1GGG1AATTTTTTTT1GGGGGG...........................................
1TTTTT11111111111111TTTTTTTT1GGGGGG1111111....................................
1TTTTTTTTTTTTTTTTTTTTTTTTTTT1GGGGGG1CCCCCC111111..............................
1TTTTTTTTTTTTTTTTTTTTTTTTTTT1GGGGGG1CCCCCCCCCCCC111111........................
1TTTTTTTTTTTTTTTTTTTTTTTTTTT1GGGGGG1CCCCCtCCCCCCCCCCCC11111...................
1TTTTTTTTTTTTTTTTTTTTTTTTTTT1GGGGGG1CCCCCCCCCCCCCCCCCCCCCCC1111...............
1TTTTTTTTTTTTTTTTTTTTTTTTTTT1GGGGGG1CCCCCCCCCCCCCCCCCCCCCCCCCCC111............
1TTTTTTTTTTTTTTTTTTTTTTTTTTT1GGGGGG1CCCCCCCCCCCCCCCCCCCCCCCCCCCCCC11..........
1TTTTT111111111111TTTTT111111GGGGGG1CCCCCCCCCCCCCCCCCCCCCCCCCCCCCCCC11........
1TTTTT1GGGGGGGGGG1TTTTTDCCCC1GGGGGG1CCCCCCCCCCrCCkCCCCCCCCCCCCCCCCCCCC1.......
1TTTTT1GGGGGGGGGG1TTTTTDCCCC1GGGGGG1CCCCCCCCCCCCCCCCCCCCCtCCCCCCCCCCCCC1......
1TTTTT1GGGGGGGGGG1TTTTTDCCCC1GGGGGG1CCCCCCCCCCCtCCCaCCCCCCCCCCCCCCCCCCC1......
1TTTTT1GGGGGGGGGG1TTTTTDCCCC1GGGGGG1CCtCCCCCCCCCCCCCCCCCCCCCCCCCCCCCCCC1......
1TTTTT1GGGGGGGGGG1TTTTTDCCCC1GGGGGG1CCCCCCCCCCCCCCCCCCCCCtCCCCCCtCCCCCCC1.....
1TTTTT1GGGGGGGGGG1TTTTT111111GGGGGG1CCCtCCCCCCCCtCCCCCCCCCCCCCCCCCCCCCCC1.....
1TTTTT1GGGGGGGGGG1TTTTTDCCCC1GGGGGG1CCCCCCCCCCCCCCCCCtCCCCCCCCCCCCCCCCCCC1....
1TTTTT1GGGGGGGGGG1TTTTTDCCCC1GGGGGG1CCCCCCCCCCCCCCCCCCCCCCCCCCCCCCCCCCCCC1....
1TTTTT1GGGGGGGGGG1TTTTTDCCCC1GGGGGG1CCCCCCCCCCCCCCCCCCCCCCCCCCtCCCCCCCCCC1....
1TTTTT1GGGGGGGGGG1TTTTTDCCCC1GGGGGG1CCCCCCCCCCCCCCCtCCCCCCCCCCCCCCCCCCCCC1....
1TTTTT1GGGGGGGGGG1TTTTTDCCCC1GGGGGG1CCCCCCCCCCCCCCCCCCCCCCCCCCCCCCCCCtCCCC1...
1TTTTT1GGGGGGG1111TTTTT111111GGGGGG1CCCCCCCtCCCCCCCCCCCCCCCCCCCtCCCCCCCCCC1...
1TTTTT1GGGGGGG1VVVTTTTTTTTTT1GGGGGG1CCCCCCCCCCCCCCCCCCCCCCCCCCCCCCCCCCCCCC1...
1TTTTT1GGGGGGG1VVVTTTTTTTTTT1GGGGGG1CCCCCCCCCCCCCCCCCtCCCCCCCCCCCCCCCCCCCC1...
1TTTTT1GGGGGGG1TTTTTTTTTTTTT1DDDDDD1CCCCCtCCCCCCCCCCCCCCCCCCCCCCCCtCCCCCCCC1..
1TTTTT1GGGGGGG1TTTTTTTTTTTTT1TTTTTTTCCCCCCCCCCCCCCCCCCCCCCCCCCCCCCCCCCCCCCC1..
1TTTTT1GGGGGGG1VVVTTTTTTTTTT1TTTTTTTCCCCCCCCCCCCCCCCCCCCCCCCCCCCCCCCCCCCCCC1..
1TTTTT1GGGGGGG1VVVTTTTTTTTTT1TTTTTTTCCCCCCCCCCCCCCCCCCCCCCCCCCCCCCCCCCCCCCC1..
1TTTTT1GGG11111111TTTTTTTTTT1TTTTTTTCCCCCCCCCCCCCCCCCCCCCCCCCCCCCCCCCCCCCCC1..
1TTTTT1GGG1ssssss1TTTTTTTTTT1TTTTTTTCCCCCCCCCCCCCCCCCCCCCCCCCCCCCCCCCCCCCCCC1.
1TTTTT1GGG1ssssss1TTTTTTTTTT1TTTTTTTCCCCCCCCCCCCCCCCCCCCCCCCCCCCCCCCCCCCCCCC1.
1TTTTT1GGG1ssssss1TTTTTTTTTTTTTTTTTTCCCCCCCCCCCCCCCCCCCCCCCCCCCCCCCCCCCCCCCC1.
1TTTTT1GGG1ssssss1TTTTTTTTTTTTTTTTTTCCCCCCCCCCCCCCCCCCCCCCCCCCCCCCCCCCCCCCCC1.
1TTTTT1GGG11111111TTTTTTTTTTTTTTTTTTCCCCCCCCCCCCCCCCCCCCCCCCCCCCCCCCCCCCCCCC1.
1TTTTT1GGG1sssssssTTTTTTTTTTTTTTTTTTCCCCCCCCCCCCCCCCCCCCCCCCCCCCCCCCCCCCCCCC11
1TTTTT1GGG1TTTTTTTTTTTTTTTTTTTTTTTTTTTTTTTTTTTTTTTTTTTTTTTTTTTTTTTTT1111111111
1TTTTT1GGG1TTTTTTTTTTTTTTTTTTTTTTTTTTTTTTTTTTTTTTTTTTTTTTTTTTTTTTTTTCCCC1bbbbR
1TTTTT1GGG1TTTTTTTTTTTTTTTTTTTTTTTTTTTTTTTTTTTTTTTTTTTTTTTTTTTTTTTTTTTTTDbbbbR
1TTTTT1GGG1TTTTTTTTTTTTTTTTTTTTTTTTTTTTTTTTTTTTTTTTTTTTTTTTTTTTTTTTTTTTTDbbbbR
1TTTTT1GGG1TTTTTTTTTTTTTTTTTEEETTTTTTTTTTTTTTTTTTTTTTTTTTTTTTTTTTTTTTTTTDbbbbR
1TTTTT1GGG1TTTTTTTTTTTTTTTTTEEETTTTTTTTTTTTTTTTTTTTTTTTTTTTTTTTTTTTTTTTTDbbbbR
1TTTTT1GGG1TTTTTTTTTTTTTTTTTEEETTTTTTTTTTTTTTTTTTTTTTTTTTTTTTTTTTTTTTTTTDbbbbR
1TTTTT1GGG1TTTTTTTTTTTTTTTTTEEETTTTTTTTTTTTTTTTTTTTTTTTTTTTTTTTTTTTTCCCC1bbbbR
1TTTTT1GGG1TTTTTTTTTTTTTTTTTTTTTTTTTTTTTTTTTTTTTTTTTTTTTTTTTTTTTTTTT1111111111
1TTTTT1GGG1TTTTTTTTTTTTTTTTTTTTTTTTTTTTTTTTTTTTTTTTTTTTTTTTTTTTTTTTTTTTT1GGGGG
1TTTTT11111TTTTTTTTTTTTTTTTTTTTTTTTTTTTTTTTTTTTTTTTTTTTTTTTTTTTTTTTTTTTT1GGGGG
1TTTTTTTTTTTTTTTTTTTTTTTTTTTTTTTTTTTTTTTTTTTTTTTTTTTTTTTTTTTTTTTTTTTTTTT1GGGGG
1TTTTTTTTTTTTTTTTTTTTTTTTTTTTTTTTTTTTTTTTTTTTTTTTTTTTTTTTTTTTTTTTTTTTTTT1GGGGG
1TTTTTTTTTTTTTTTTTTTTTTTTTTTTTTTTTTTTTTTTTTTTTTTTTTTTTTTTTTTTTTTTTTTTTTT1GGGGG
1TTTTTTTTTTTTTTTTTTTTTTTTTTTTTTTTTTTTTTTTTTTTTTTTTTTTTTTTTTTTTTTTTTTTTTT1GGGGG
1TTTTTTTTTTTTTTTTTTTTTTTTTTTTTTTTTTTTTTTTTTTTTTTTTTTTTTTTTTTTTTTTTTTTTTT1GGGGG
1TTTTTTTTTTTTTTTTTTTTTTTTTTTTTTTTTTTTTTTTTTTTTTTTTTTTTTTTTTTTTTTTTTTTTTT1GGGGG
1111111111111111111111111111111111111111111111111111111111111111111111111GGGGG