11111111111111...111111111111..................................................
1TTTTTDCCCCCC1...1AATTTTTTTT1..................................................
1TTTTTDCCCCCC1...1AATTTTTTTT1..................................................
1TTTTTDCCCCCC1...1AATTTTTTTT1..................................................
1TTTTTDCCCCCC1...1AATTTTTTTT1..................................................
1TTTTTDCCCCCC1...1AATTTTTTTT1..................................................
1TTTTTDSSSSSS1...1AATTTTTTTT1..................................................
1TTTTT11111111111111TTTTTTTT1......1111111.....................................
1TTTTTTTTTTTTTTTTTTTTTTTTTTT1......1CCCCCC111111...............................
1TTTTTTTTTTTTTTTTTTTTTTTTTTT1......1CCCCCCCCCCCC111111.........................
1TTTTTTTTTTTTTTTTTTTTTTTTTTT1......1CCCCCCCCCCCCCCCCCC11111....................
1TTTTTTTTTTTTTTTTTTTTTTTTTTT1......1CCCCCCCCCCCCCCCCCCCCCCC1111................
1TTTTTTTTTTTTTTTTTTTTTTTTTTT1......1CCCCCCCCCCCCCCCCCCCCCCCCCCC111.............
1TTTTTTTTTTTTTTTTTTTTTTTTTTT1......1CCCCCCCCCCCCCCCCCCCCCCCCCCCCCC11...........
1TTTTT111111111111TTTTT111111......1CCCCCCCCCCCCCCCCCCCCCCCCCCCCCCCC11........
1TTTTT1..........1TTTTTDCCCC1......1CCCCCCCCCCCCCCCCCCCCCCCCCCCCCCCCCC1.......
1TTTTT1..........1TTTTTDCCCC1......1CCCCCCCCCCCCCCCCCCCCCCCCCCCCCCCCCCC1......
1TTTTT1..........1TTTTTDCCCC1......1CCCCCCCCCCCCCCCCCCCCCCCCCCCCCCCCCCC1......
1TTTTT1..........1TTTTTDCCCC1......1CCCCCCCCCCCCCCCCCCCCCCCCCCCCCCCCCCC1......
1TTTTT1..........1TTTTTDCCCC1......1CCCCCCCCCCCCCCCCCCCCCCCCCCCCCCCCCCCC1.....
1TTTTT1..........1TTTTT111111......1CCCCCCCCCCCCCCCCCCCCCCCCCCCCCCCCCCCC1.....
1TTTTT1..........1TTTTTDCCCC1......1CCCCCCCCCCCCCCCCCCCCCCCCCCCCCCCCCCCCC1....
1TTTTT1..........1TTTTTDCCCC1......1CCCCCCCCCCCCCCCCCCCCCCCCCCCCCCCCCCCCC1....
1TTTTT1..........1TTTTTDCCCC1......1CCCCCCCCCCCCCCCCCCCCCCCCCCCCCCCCCCCCC1....
1TTTTT1..........1TTTTTDCCCC1......1CCCCCCCCCCCCCCCCCCCCCCCCCCCCCCCCCCCCC1....
1TTTTT1..........1TTTTTDCCCC1......1CCCCCCCCCCCCCCCCCCCCCCCCCCCCCCCCCCCCCC1...
1TTTTT1.......1111TTTTT111111......1CCCCCCCCCCCCCCCCCCCCCCCCCCCCCCCCCCCCCC1...
1TTTTT1.......1VVVTTTTTTTTTT1......1CCCCCCCCCCCCCCCCCCCCCCCCCCCCCCCCCCCCCC1...
1TTTTT1.......1VVVTTTTTTTTTT1......1CCCCCCCCCCCCCCCCCCCCCCCCCCCCCCCCCCCCCC1...
1TTTTT1.......1TTTTTTTTTTTTT1DDDDDD1CCCCCCCCCCCCCCCCCCCCCCCCCCCCCCCCCCCCCCC1..
1TTTTT1.......1TTTTTTTTTTTTT1TTTTTTTCCCCCCCCCCCCCCCCCCCCCCCCCCCCCCCCCCCCCCC1..
1TTTTT1.......1VVVTTTTTTTTTT1TTTTTTTCCCCCCCCCCCCCCCCCCCCCCCCCCCCCCCCCCCCCCC1..
1TTTTT1.......1VVVTTTTTTTTTT1TTTTTTTCCCCCCCCCCCCCCCCCCCCCCCCCCCCCCCCCCCCCCC1..
1TTTTT1...11111111TTTTTTTTTT1TTTTTTTCCCCCCCCCCCCCCCCCCCCCCCCCCCCCCCCCCCCCCC1..
1TTTTT1...1SSSSSS1TTTTTTTTTT1TTTTTTTCCCCCCCCCCCCCCCCCCCCCCCCCCCCCCCCCCCCCCCC1.
1TTTTT1...1SSSSSS1TTTTTTTTTT1TTTTTTTCCCCCCCCCCCCCCCCCCCCCCCCCCCCCCCCCCCCCCCC1.
1TTTTT1...1SSSSSS1TTTTTTTTTTTTTTTTTTCCCCCCCCCCCCCCCCCCCCCCCCCCCCCCCCCCCCCCCC1.
1TTTTT1...1SSSSSS1TTTTTTTTTTTTTTTTTTCCCCCCCCCCCCCCCCCCCCCCCCCCCCCCCCCCCCCCCC1.
1TTTTT1...11111111TTTTTTTTTTTTTTTTTTCCCCCCCCCCCCCCCCCCCCCCCCCCCCCCCCCCCCCCCC1.
1TTTTT1...1SSSSSSSTTTTTTTTTTTTTTTTTTCCCCCCCCCCCCCCCCCCCCCCCCCCCCCCCCCCCCCCCC11
1TTTTT1...1TTTTTTTTTTTTTTTTTTTTTTTTTTTTTTTTTTTTTTTTTTTTTTTTTTTTTTTTT1111111111
1TTTTT1...1TTTTTTTTTTTTTTTTTTTTTTTTTTTTTTTTTTTTTTTTTTTTTTTTTTTTTTTTTCCCC1....R
1TTTTT1...1TTTTTTTTTTTTTTTTTTTTTTTTTTTTTTTTTTTTTTTTTTTTTTTTTTTTTTTTTTTTTD....R
1TTTTT1...1TTTTTTTTTTTTTTTTTTTTTTTTTTTTTTTTTTTTTTTTTTTTTTTTTTTTTTTTTTTTTD....R
1TTTTT1...1TTTTTTTTTTTTTTTTTEEETTTTTTTTTTTTTTTTTTTTTTTTTTTTTTTTTTTTTTTTTD....R
1TTTTT1...1TTTTTTTTTTTTTTTTTEEETTTTTTTTTTTTTTTTTTTTTTTTTTTTTTTTTTTTTTTTTD....R
1TTTTT1...1TTTTTTTTTTTTTTTTTEEETTTTTTTTTTTTTTTTTTTTTTTTTTTTTTTTTTTTTTTTTD....R
1TTTTT1...1TTTTTTTTTTTTTTTTTEEETTTTTTTTTTTTTTTTTTTTTTTTTTTTTTTTTTTTTCCCC1....R
1TTTTT1...1TTTTTTTTTTTTTTTTTTTTTTTTTTTTTTTTTTTTTTTTTTTTTTTTTTTTTTTTT1111111111
1TTTTT1...1TTTTTTTTTTTTTTTTTTTTTTTTTTTTTTTTTTTTTTTTTTTTTTTTTTTTTTTTTTTTT1.....
1TTTTT11111TTTTTTTTTTTTTTTTTTTTTTTTTTTTTTTTTTTTTTTTTTTTTTTTTTTTTTTTTTTTT1.....
1TTTTTTTTTTTTTTTTTTTTTTTTTTTTTTTTTTTTTTTTTTTTTTTTTTTTTTTTTTTTTTTTTTTTTTT1.....
1TTTTTTTTTTTTTTTTTTTTTTTTTTTTTTTTTTTTTTTTTTTTTTTTTTTTTTTTTTTTTTTTTTTTTTT1.....
1TTTTTTTTTTTTTTTTTTTTTTTTTTTTTTTTTTTTTTTTTTTTTTTTTTTTTTTTTTTTTTTTTTTTTTT1.....
1TTTTTTTTTTTTTTTTTTTTTTTTTTTTTTTTTTTTTTTTTTTTTTTTTTTTTTTTTTTTTTTTTTTTTTT1.....
1TTTTTTTTTTTTTTTTTTTTTTTTTTTTTTTTTTTTTTTTTTTTTTTTTTTTTTTTTTTTTTTTTTTTTTT1.....
1TTTTTTTTTTTTTTTTTTTTTTTTTTTTTTTTTTTTTTTTTTTTTTTTTTTTTTTTTTTTTTTTTTTTTTT1.....
1111111111111111111111111111111111111111111111111111111111111111111111111.....