11111111111111111111111111111111
1..............................1
1...................1..........1
1...................1..........1
1..............111111..........1
1..............1....1..........1
1..............1....1..........1
1..............1....1..........1
1..............................1
1..............................1
1..............................1
1..............................1
1..............................1
1..............................1
1..............................1
1................EEE...........1
1................EEE...........1
1................EEE...........1
1..............................1
1..............................1
1..............................1
1..............................1
1..............................1
1..............................1
1..............................1
1..............................1
1..............................1
1..............................1
1..............................1
1..............................1
1..............................1
11111111111111111111111111111111