11111111111111...111111111111..................................................
1TTTTTDCCCCCC1...1AATTTTTTTT1..................................................
1TTTTTDCtCCCC1...1AATTTTTTTT1..................................................
1TTTTTDCCCCCC1...1AATTTTTTTT1..................................................
1TTTTTDCCCCCC1...1AATTTTTTTT1..................................................
1TTTTTDCCCCCC1...1AATTTTTTTT1..................................................
1TTTTTDSSSSSS1...1AATTTTTTTT1..................................................
1TTTTT11111111111111TTTTTTTT1......1111111.....................................
1TTTTTTTTTTTTTTTTTTTTTTTTTTT1......1CCCCCC111111...............................
1TTTTTTTTTTTTTTTTTTTTTTTTTTT1......1CCCCCCCCCCCC111111.........................
1TTTTTTTTTTTTTTTTTTTTTTTTTTT1......1CCCCCtCCCCCCCCCCCC11111....................
1TTTTTTTTTTTTTTTTTTTTTTTTTTT1......1CCCCCCCCCCCCCCCCCCCCCCC1111................
1TTTTTTTTTTTTTTTTTTTTTTTTTTT1......1CCCCCCCCCCCCCCCCCCCCCCCCCCC111.............
1TTTTTTTTTTTTTTTTTTTTTTTTTTT1......1CCCCCCCCCCCCCCCCCCCCCCCCCCCCCC11...........
1TTTTT111111111111TTTTT111111......1CCCCCCCCCCCCCCCCCCCCCCCCCCCCCCCC11........
1TTTTT1..........1TTTTTDCCCC1......1CCCCCCCCCCrCCkCCCCCCCCCCCCCCCCCCCC1.......
1TTTTT1..........1TTTTTDCCCC1......1CCCCCCCCCCCCCCCCCCCCCtCCCCCCCCCCCCC1......
1TTTTT1..........1TTTTTDCCCC1......1CCCCCCCCCCCtCCCaCCCCCCCCCCCCCCCCCCC1......
1TTTTT1..........1TTTTTDCCCC1......1CCtCCCCCCCCCCCCCCCCCCCCCCCCCCCCCCCC1......
1TTTTT1..........1TTTTTDCCCC1......1CCCCCCCCCCCCCCCCCCCCCtCCCCCCtCCCCCCC1.....
1TTTTT1..........1TTTTT111111......1CCCtCCCCCCCCtCCCCCCCCCCCCCCCCCCCCCCC1.....
1TTTTT1..........1TTTTTDCCCC1......1CCCCCCCCCCCCCCCCCtCCCCCCCCCCCCCCCCCCC1....
1TTTTT1..........1TTTTTDCCCC1......1CCCCCCCCCCCCCCCCCCCCCCCCCCCCCCCCCCCCC1....
1TTTTT1..........1TTTTTDCCCC1......1CCCCCCCCCCCCCCCCCCCCCCCCCCtCCCCCCCCCC1....
1TTTTT1..........1TTTTTDCCCC1......1CCCCCCCCCCCCCCCtCCCCCCCCCCCCCCCCCCCCC1....
1TTTTT1..........1TTTTTDCCCC1......1CCCCCCCCCCCCCCCCCCCCCCCCCCCCCCCCCtCCCC1...
1TTTTT1.......1111TTTTT111111......1CCCCCCCtCCCCCCCCCCCCCCCCCCCtCCCCCCCCCC1...
1TTTTT1.......1VVVTTTTTTTTTT1......1CCCCCCCCCCCCCCCCCCCCCCCCCCCCCCCCCCCCCC1...
1TTTTT1.......1VVVTTTTTTTTTT1......1CCCCCCCCCCCCCCCCCtCCCCCCCCCCCCCCCCCCCC1...
1TTTTT1.......1TTTTTTTTTTTTT1DDDDDD1CCCCCtCCCCCCCCCCCCCCCCCCCCCCCCtCCCCCCCC1..
1TTTTT1.......1TTTTTTTTTTTTT1TTTTTTTCCCCCCCCCCCCCCCCCCCCCCCCCCCCCCCCCCCCCCC1..
1TTTTT1.......1VVVTTTTTTTTTT1TTTTTTTCCCCCCCCCCCCCCCCCCCCCCCCCCCCCCCCCCCCCCC1..
1TTTTT1.......1VVVTTTTTTTTTT1TTTTTTTCCCCCCCCCCCCCCCCCCCCCCCCCCCCCCCCCCCCCCC1..
1TTTTT1...11111111TTTTTTTTTT1TTTTTTTCCCCCCCCCCCCCCCCCCCCCCCCCCCCCCCCCCCCCCC1..
1TTTTT1...1ssssss1TTTTTTTTTT1TTTTTTTCCCCCCCCCCCCCCCCCCCCCCCCCCCCCCCCCCCCCCCC1.
1TTTTT1...1ssssss1TTTTTTTTTT1TTTTTTTCCCCCCCCCCCCCCCCCCCCCCCCCCCCCCCCCCCCCCCC1.
1TTTTT1...1ssssss1TTTTTTTTTTTTTTTTTTCCCCCCCCCCCCCCCCCCCCCCCCCCCCCCCCCCCCCCCC1.
1TTTTT1...1ssssss1TTTTTTTTTTTTTTTTTTCCCCCCCCCCCCCCCCCCCCCCCCCCCCCCCCCCCCCCCC1.
1TTTTT1...11111111TTTTTTTTTTTTTTTTTTCCCCCCCCCCCCCCCCCCCCCCCCCCCCCCCCCCCCCCCC1.
1TTTTT1...1sssssssTTTTTTTTTTTTTTTTTTCCCCCCCCCCCCCCCCCCCCCCCCCCCCCCCCCCCCCCCC11
1TTTTT1...1TTTTTTTTTTTTTTTTTTTTTTTTTTTTTTTTTTTTTTTTTTTTTTTTTTTTTTTTT1111111111
1TTTTT1...1TTTTTTTTTTTTTTTTTTTTTTTTTTTTTTTTTTTTTTTTTTTTTTTTTTTTTTTTTCCCC1....R
1TTTTT1...1TTTTTTTTTTTTTTTTTTTTTTTTTTTTTTTTTTTTTTTTTTTTTTTTTTTTTTTTTTTTTD....R
1TTTTT1...1TTTTTTTTTTTTTTTTTTTTTTTTTTTTTTTTTTTTTTTTTTTTTTTTTTTTTTTTTTTTTD....R
1TTTTT1...1TTTTTTTTTTTTTTTTTEEETTTTTTTTTTTTTTTTTTTTTTTTTTTTTTTTTTTTTTTTTD....R
1TTTTT1...1TTTTTTTTTTTTTTTTTEEETTTTTTTTTTTTTTTTTTTTTTTTTTTTTTTTTTTTTTTTTD....R
1TTTTT1...1TTTTTTTTTTTTTTTTTEEETTTTTTTTTTTTTTTTTTTTTTTTTTTTTTTTTTTTTTTTTD....R
1TTTTT1...1TTTTTTTTTTTTTTTTTEEETTTTTTTTTTTTTTTTTTTTTTTTTTTTTTTTTTTTTCCCC1....R
1TTTTT1...1TTTTTTTTTTTTTTTTTTTTTTTTTTTTTTTTTTTTTTTTTTTTTTTTTTTTTTTTT1111111111
1TTTTT1...1TTTTTTTTTTTTTTTTTTTTTTTTTTTTTTTTTTTTTTTTTTTTTTTTTTTTTTTTTTTTT1.....
1TTTTT11111TTTTTTTTTTTTTTTTTTTTTTTTTTTTTTTTTTTTTTTTTTTTTTTTTTTTTTTTTTTTT1.....
1TTTTTTTTTTTTTTTTTTTTTTTTTTTTTTTTTTTTTTTTTTTTTTTTTTTTTTTTTTTTTTTTTTTTTTT1.....
1TTTTTTTTTTTTTTTTTTTTTTTTTTTTTTTTTTTTTTTTTTTTTTTTTTTTTTTTTTTTTTTTTTTTTTT1.....
1TTTTTTTTTTTTTTTTTTTTTTTTTTTTTTTTTTTTTTTTTTTTTTTTTTTTTTTTTTTTTTTTTTTTTTT1.....
1TTTTTTTTTTTTTTTTTTTTTTTTTTTTTTTTTTTTTTTTTTTTTTTTTTTTTTTTTTTTTTTTTTTTTTT1.....
1TTTTTTTTTTTTTTTTTTTTTTTTTTTTTTTTTTTTTTTTTTTTTTTTTTTTTTTTTTTTTTTTTTTTTTT1.....
1TTTTTTTTTTTTTTTTTTTTTTTTTTTTTTTTTTTTTTTTTTTTTTTTTTTTTTTTTTTTTTTTTTTTTTT1.....
1111111111111111111111111111111111111111111111111111111111111111111111111.....